NO ./assets/dark_oak_log.xpm
SO ./assets/dark_oak_log.xpm
WE ./assets/dark_oak_planks.xpm
EA ./assets/dark_oak_planks.xpm

F 256,256,256
C 256,256,256


        1111111111111111111111111
        1000000000110000000000001
        1011000001110000000000001
        10010000000000000000G0001
111111111011000001110000000000001
10000000001100000111D111111111111
11110111111111011100000010001
111101111111110111010100100C1
11000000110101011100000010001
10000000000000001100000010001
10000000000000001101010000001
11000001110101011111011110W0111
11110111 1110101 111111110001
11111111 1111111 111111111111
