NO ./assets/dark_oak_log.xpm
SO ./assets/dark_oak_log.xpm
WE ./assets/dark_oak_planks.xpm
EA ./assets/dark_oak_planks.xpm

F 246,107,131
C 1,156,187

1111111111
1000000001
1000000001
100000N001
1111111111
